psbA	photosystem II protein D1
trnK-UUU	tRNA-Lys
matK	maturase K
rps16	ribosomal protein 16
trnQ-UUG	tRNA-Gln
psbK	photosystem II protein K
psbI	photosystem II protein I
trnS-GCU	tRNA-Ser
psbD	photosystem II protein D2
psbC	photosystem II 44 kDa protein
trnS-UGA	tRNA-Ser
psbZ	photosystem II protein Z	photosystem II reaction center Z protein; YCF9
trnG-UCC	tRNA-Gly
trnfM-CAU	tRNA-Met	fMet
orf147	putative protein 147	Putative protein product originally identified in NCo 310 cultivar, also present in Zea mays. Similar to hypothetical protein SORBIDRAFT_03g017511 [Sorghum bicolor]
trnT-GGU	tRNA-Thr
trnE-UUC	tRNA-Glu
trnY-GUA	tRNA-Tyr
trnD-GUC	tRNA-Asp
psbM	photosystem II protein M
petN	cytochrome b6/f complex subunit VIII
trnC-GCA	tRNA-Cys
rpoB	RNA polymerase beta subunit	RNA polymerase beta chain; one of four subunits of the minimal PEP RNA polymerase catalytic core
rpoC1	RNA polymerase beta' subunit
rpoC2	RNA polymerase beta'' subunit
rps2	30S ribosomal protein S2
atpI	ATP synthase CF0 A subunit	ATPase IV subunit; ATP synthase CF0 A chain
atpH	ATP synthase CF0 C subunit	ATPase III subunit; ATP synthase CF0 C chain
atpF	ATP synthase CF0 B subunit	ATPase subunit I
atpA	ATP synthase CF1 alpha subunit	ATP synthase CF1 alpha chain; ATPase alpha subunit
trnR-UCU	tRNA-Arg
trnfM-CAU	tRNA-Met
rps14	ribosomal protein S14	30S ribosomal protein S14
psaB	photosystem I P700 chlorophyll a apoprotein A2	PSI P700 apoprotein A2; PsaB
psaA	photosystem I P700 chlorophyll a apoprotein A1	PSI P700 apoprotein A1; PsaA
ycf3	photosystem I assembly protein Ycf3
trnS-GGA	tRNA-Ser
trnT-UGU	tRNA-Thr
trnL-UAA	tRNA-Leu
trnF-GAA	tRNA-Phe
ndhJ	NADH dehydrogenase subunit J	NADH dehydrogenase 30 kDa subunit
ndhK	NADH dehydrogenase subunit K	NADH dehydrogenase 27 kDa subunit
ndhC	NADH dehydrogenase subunit 3
trnV-UAC	tRNA-Val
trnM-CAU	tRNA-Met
atpE	ATP synthase CF1 epsilon subunit	ATP synthase epsilon chain
atpB	ATP synthase CF1 beta subunit
rbcL	ribulose-1,5-bisphosphate carboxylase/oxygenase large subunit
psaI	photosystem I subunit VIII	PSI I-protein
ycf4	photosystem I assembly protein Ycf4
cemA	chloroplast envelope membrane protein
petA	cytochrome f	apocytochrome f precursor; component of cytochrome b6/f complex
psbJ	photosystem II protein J	photosystem II reaction center subunit X
psbL	photosystem II protein L	PSII reaction center subunit XII
psbF	photosystem II protein VI	photosystem II reaction center subunit VI
psbE	photosystem II protein V	cytochrome b559 alpha subunit
petL	cytochrome b6/f complex subunit VI	cytochrome b6/f complex 6
petG	cytochrome b6/f complex subunit V	cytochrome B6-F complex subunit 5; required for the either the stability or assembly of the cytochrome b6/f complex
trnW-CCA	tRNA-Trp
trnP-UGG	tRNA-Pro
psaJ	photosystem I subunit IX	photosystem I protein J
rpl33	ribosomal protein L33	50S ribosomal protein L33
rps18	ribosomal protein S18	30S ribosomal protein S18
rpl20	ribosomal protein L20	50S ribosomal protein L20
rps12	ribosomal protein S12
clpP	ATP-dependent Clp protease proteolytic subunit
psbB	photosystem II 47 kDa protein	photosystem II P680 chlorophyll A apoprotein; PSII 47 kDa protein
psbT	photosystem II protein T
psbN	photosystem II protein N	photosystem II reaction center N protein
psbH	photosystem II protein H	photosystem II reaction center protein H; photosystem II phosphoprotein
petB	cytochrome b6
petD	cytochrome b6/f complex subunit IV	cytochrome b6/f complex subunit 4
rpoA	RNA polymerase alpha subunit	RNA polymerase alpha chain
rps11	ribosomal protein S11	30S ribosomal protein S11
rpl36	ribosomal protein L36
infA	translational initiation factor 1
rps8	ribosomal protein S8	30S ribosomal protein S8
rpl14	ribosomal protein L14
rpl16	ribosomal protein L16
rps3	ribosomal protein S3	30S ribosomal protein S3
rpl22	ribosomal protein L22
rps19	ribosomal protein S19	30S ribosomal protein S19
orf74	hypothetical protein 74	Putative protein product originally identified in NCo 310 cultivar, also present in Zea mays and Oryza sativa
trnH-GUG	tRNA-His
rpl2	ribosomal protein L2	50S ribosomal protein L2
orf137	putative protein 137	Putative protein product present in many Poales species plastids
rpl23	ribosomal protein L23	50S ribosomal protein L23
rpl231   ribosomal protein L23   50S ribosomal protein L23
trnI-CAU	tRNA-Ile
ycf2	Ycf2	hypothetical protein RF2
ycf15	hypothetical chloroplast RF15
ycf73	Hypothetical chloroplast RF73	Putative protein product annotated by homology to Oryza sativa
trnL-CAA	tRNA-Leu
orf69	hypothetical protein 69	Putative protein product identified by homology to members of the BOP and PACMAD clades
ndhB	NADH-plastoquinone oxidoreductase subunit 2
rps7	ribosomal protein S7	30S ribosomal protein S7
orf58	putative protein 58	Putative protein product originally identified in NCo 310 cultivar, present in many monocot and dicot lineages
orf85	putative protein 85	Putative protein product present in a range of poales lineages
trnV-GAC	tRNA-Val
rrn16	16S ribosomal RNA
trnI-GAU	tRNA-Ile
ycf68	hypothetical chloroplast RF68
trnA-UGC	tRNA-Ala
orf49	putative protein 49	Putative protein product in the trnA intron with homologues in the PACMAD and BOP clades
rrn23	23S ribosomal RNA
rrn4.5	4.5S ribosomal RNA
rrn5	5S ribosomal RNA
trnR-ACG	tRNA-Arg
trnN-GUU	tRNA-Asn
ycf1 80	hypothetical protein RF19, 80bp	Putative protein product in the ycf1 pseudogene region
rps15	ribosomal protein S15
ndhF	NADH dehydrogenase subunit 5
rpl32	ribosomal protein L32
trnL-UAG	tRNA-Leu
ccsA	cytochrome c biogenesis protein
ndhD	NADH dehydrogenase subunit 4
psaC	photosystem I subunit VII	photosystem I iron-sulfur center; 9 kDa protein
ndhE	NADH dehydrogenase subunit 4L
ndhG	NADH dehydrogenase subunit 6
ndhI	NADH dehydrogenase subunit I	NADH dehydrogenase 18 kDa subunit
ndhA	NADH dehydrogenase subunit 1
ndhH	NADH-plastoquinone oxidoreductase subunit 7	NADH dehydrogenase 49 kDa subunit
rps15	ribosomal protein S15
ycf1 80	hypothetical protein RF19, 80bp	Putative protein product in the ycf1 pseudogene region
trnN-GUU	tRNA-Asn
trnR-ACG	tRNA-Arg
rrn5	5S ribosomal RNA
rrn4.5	4.5S ribosomal RNA
rrn23	23S ribosomal RNA
trnA-UGC	tRNA-Ala
orf49	putative protein 49	Putative protein product in the trnA intron with homologues in the PACMAD and BEP clades
trnI-GAU	tRNA-Ile
ycf68	hypothetical chloroplast RF68
rrn16	16S ribosomal RNA
trnV-GAC	tRNA-Val
orf85	putative protein 85	Putative protein product present in a range of poales lineages
orf58	putative protein 58	Putative protein product originally identified in NCo 310 cultivar, present in many monocot and dicot lineages
rps7	ribosomal protein S7	30S ribosomal protein S7
ndhB	NADH-plastoquinone oxidoreductase subunit 2
orf69	hypothetical protein 69	Putative protein product identified by homology to members of the BOP and PACMAD clades
orf68	hypothetical protein 68	utative protein product identified by homology to members of the BOP and PACMAD clades
trnL-CAA	tRNA-Leu
ycf73	Hypothetical chloroplast RF73	Putative protein product annotated by homology to Oryza sativa
ycf15	hypothetical chloroplast RF15
ycf2	Ycf2	hypothetical protein RF2
trnI-CAU	tRNA-Ile
rpl23	ribosomal protein L23	50S ribosomal protein L23
rpl2	ribosomal protein L2	50S ribosomal protein L2
orf137	putative protein 137	Putative protein product present in many Poales species plastids
orf74	hypothetical protein 74	Putative protein product originally identified in NCo 310 cultivar, also present in Zea mays and Oryza sativa
trnH-GUG	tRNA-His
rps19	ribosomal protein S19	30S ribosomal protein S19
rps4	ribosomal protein S4
trnG-GCC	tRNA-Gly
LSC	long single copy region; LSC
IRA	IRA, Inverted Repeat Region, Copy A
IRB	IRB, Inverted Repeat Region, Copy B
SSC	short single copy region; SSC
oriA1	origin of replication
oriA1c	origin of replication
oriA2	origin of replication
oriA2c	origin of replication
ACRS-pseudo	ACR toxin sensitivity protein pseudogene	Gained by translocation wit the mitochondrial genome
rpl2-pseudo	rpl2 pseudogene for ribosomal protein L2
tRNA-Thr-pseudo	tRNA-Thr(GGU)	trnT pseudogene for tRNA-Thr(GGU)
rpl23-pseudo	rpl23 pseudogene for ribosomal protein L23
